111111
10S001
100011
10101
11111
