
NO ./textures/wall1.xpm
SO ./textures/wall2.xpm
WE ./textures/wall3.xpm
EA ./textures/wall4.xpm

F 255,255,255
C 0,0,0

11111
10W01
10101
10001
11011
 1011
 1001
 1011
 1001
 1011
 1001
 1011
 111