11111
10S01
10001
10101
11111
