111111111
100000001          
101011101 	
10100 001
10000 001     1                             
10N00 00111111
110011101
 11111111
