
NO ./textures/greystone.xpm
SO ./textures/greystone.xpm
WE ./textures/greystone.xpm
EA ./textures/Wall1.xpm

F 255,255,255
C 0,0,255

11111111111
1E000000001
11110000001
10000000111
100000001
1110000111
1000000001
1111111111 	 	