
NO ./textures/wall1.xpm
SO ./textures/wall2.xpm
WE ./textures/wall3.xpm
EA ./textures/wall4.xpm

F 255,255,255
C 0,255,0

11111111111 	 	
1E000000001
11110000001
   10000111 	 	
  1100001
1110000111 	 	
1000000001
1111111111
