      11111111111 	 	 
      1E000000001
      11110000001
        100001111 	 	 
        100001
      1110000111 	 	 
      1000000001
      1111111111
