      11111111111 	 	 
      10000000001
      11110000001
        100001111 	 	 
        10S001
      1110000111 	 	 
      1000000001
      1111111111
