      11111111111 	 	 
    111E000000001
      11110000001
        100001111 	 	 
        100001
      1110000111 	 	 
  11111000000001
      1111111111
