





F 255,255,255
C 0,1,12


NO ./textures/wall1.xpm
SO ./textures/wall2.xpm
WE ./textures/wall3.xpm
EA ./textures/wall4.xpm



11111
1
1
1
11111101111
1E000000001
11110000001
10000000011     1
1000000011
1110000111
1000000001
1111111111 	 	1




1
